6
6
8
8
22222222
22222222
22222222
22222222
22222222
22222222
22222222
22222222
11111111
10001001
10001001
10001001
10001001
10001001
10000001
11111111
00000000
00002000
00000000
00000000
00000000
00000000
00002000
00000000
00000000
00000000
00000000
00000000
00000000
00000000
00000000
00000000